|-----------------------------------------------------------------------------------------|
|-----------------------------------------------------------------------------------------|
|-----------------------------------------------------------------------------------------|
|-----------------------------------------------------------------------------------------|
|-----------------------------------------------------------------------------------------|
|-----------------------______________________--------------------------------------------|
|----------------------|                      |-------------------------------------------|
|----------------------|                      |-------------------------------------------|
|----------------------|                      |-------------------------------------------|
|----------------------|                      |-------------------------------------------|
|---------------------/                       |-------------------------------------------|
|---------------------|                       |-------------------------------------------|
|---------------------|_____                   \------------------------------------------|
|---------------------------\                   \-----------------------------------------|
|----------------------------|                   \----------------------------------------|
|----------------------------|                    |---------------------------------------|
|----------------------------|                    |---------------------------------------|
|----------------------------|____________________|---------------------------------------|
|-----------------------------------------------------------------------------------------|
|-----------------------------------------------------------------------------------------|
|-----------------------------------------------------------------------------------------|
|-----------------------------------------------------------------------------------------|
|-----------------------------------------------------------------------------------------|
|-----------------------------------------------------------------------------------------|
|-----------------------------------------------------------------------------------------|
|-------------------------------------*---------------------------------------------------|
|-----------------------------------------------------------------------------------------|
|-----------------------------------------------------------------------------------------|
|-----------------------------------------------------------------------------------------|
|-----------------------------------------------------------------------------------------|

The Castle
The Fields
The Village
